A
advanced = lanjut
align = perataan
author = pengarang


B
bar = bilah
bookmark = markah buku
border = batas / tepi
breakpoint = 
bullet = bulatan

C
cancel = batal
cell = sel
chart = (tergantung konteks) bagan / grafik
click = klik
clicking = mengeklik
close = tutup
column = kolom
console = konsol
content = konten
count = hitung
copy = salin (kk), salinan (kb)
custom = ubahan
current = saat ini

D
database = pangkalan data
default = baku, bawaan
description = deskripsi, keterangan
digital = digital
disable = matikan
disabled = dimatikan
disc = diska
disk = diska
document = dokumen
download = unduh
driver = pemacu/penggerak --cek

E
email = surel
embed = tanamkan
enable = nyalakan
enabled = dinyalakan
error = galat
export = ekspor
extension = ekstensi
event = kejadian

F
field = ruas
file = berkas
footer = kaki
form = formulir
format = format

G
grid = kisi

H
harddisk = diska
home = beranda
header = tajuk
hyperlink = pranala

I
image = citra
import = impor
insert = sisipkan
item = item

J


K


L
library = pustaka
libraries = pustaka
link = tautan

M
margin = batasan
mean = rerata
mouse = tetikus
multiple = 

N
null = nol


O
offline = luring
online = daring
on the fly = dengan cepat
option = opsi, pilihan
output = keluaran
overwrite = menimpa

P
pause = jeda (kb) menjeda (kk)
pop up = ?
preference = preferensi
presenter = penyaji
preview = pratinjau
printer = pencetak

Q
query = query

R
range = rentang
recent = terkini
reference = referensi
region = wilayah
remove = hapuskan
replace = 
restart = mulai ulang
review = tinjau
run = 
row = baris

S
setting = pengaturan
server = server
shape = bentuk
shortcut = pintasan
slide = salindia
spreadsheet = ?
syntax = sintaksis

T
tab = tab
tabbed = tab
template = templat
text = teks
then = kemudian
through = lewati
thumbnail = thumbnail
tips = tips
toogle = jungkit
toolbar = bilah alat
tools = perkakas
tooltip = ?
twip = twip

U
update = pemutakhiran (kb), mutakhirkan (kk)
upload = unggah
user = pengguna
username = nama pengguna

V
valid = valid
view = tampilan

W
wizard = wisaya
worksheet = lembar kerja
wrap = bungkus

X


Y


Z
